1111111111111111
1000100000000E01
1000100000011001
1000000000010001
10000000C0000001
100P000000000001
1111111111111111
