1111111111111111
1C00100C00000E01
1000100000011001
100000C0000100C1
10000000C0000001
100P0000000C0001
1111111111111111
