1111111111111111111111111111111
10C010000C000E0000C100000001111
1000100000010000000100000000001
1000011000000011000000001100111
10000111000A0001000000000011111
1000011100000001000000000011111
10C0000000010000000110000000111
1000A000C0000000000111000000011
10000000C0000000110001000000011
10000000000000000001110000A0011
1000011110000000000001000000011
10000000C0000A00000001101100001
1C0P000000000000011000C01100C01
1111111111111111111111111111111
