1111111111111111111111111111111
10C010000C00A01000C1000000E1111
1000100000010001000100000000001
1000011000000011000000001100111
10000111000A0001000001000011111
1000011100000001100000000011111
10C0000000010000110110000000111
1000A000C0000000000111000000011
10000000C0000000110001000000011
10000000000000000001110000A0011
1000011110000000000001000000011
100000P0C0000A00000001101100001
1C01000000000000011000C11100C01
1111111111111111111111111111111
